1111111111111111
100000000C000011
1P00000000011111
1000011111110001
1C00000000000001
1000000000E11111
1111111111111111