1111111111111111
10C000000C000011
1P00000000011111
1011011111110001
1C00010000000001
10000C0000E11111
1111111111111111
