11111
1P001
10C01
10011
10E11
10001
1C011
11111
