111111111
1P0C00001
100CCC001
10C0CCCE1
111111111
